%s An update is available=%s: Eine Aktualisierung ist verfügbar
Alert Message=Alarmnachricht
anonymous=Anonym
Author=Autor
Check For Updates=Nach Aktualisierungen suchen
Checking connectivity=Verbindung wird geprüft
checking=Prüfe
Click here to install version %s=Hier klicken, um Version %s zu installieren
Delete Plugin=Plugin löschen
DOWNGRADE TO VERSION=DOWNGRADE AUF VERSION
Enter URL of remote plugin file or local plugin file=URL des Plugins eingeben oder eine lokale Plugin-Datei auswählen
ERROR=FEHLER
I have read the release notes=Ich habe die Veröffentlichungshinweise gelesen
Install Plugin=Plugin installieren
Install=Installieren
install=installieren
Installed Plugins=Installierte Plugins
Installing Update=Installiere Aktualisierung
need check=Benötigt Prüfung
Next=Nächste
No plugins installed=Keine Plugins installiert
No release notes available=Keine Veröffentlichungshinweise vorhanden
No response, aborting=Keine Antwort, Abbruch
Plugin File Install Errors=Plugin-Datei Installationsfehler
Plugin File=Plugin-Datei
Plugin History=Plugin-Verlauf
Plugin Update Check=Nach Plugin-Aktualisierungen suchen
Plugin=Plugin
Release Notes=Veröffentlichungshinweise
Remove Plugin=Plugin entfernen
Remove Selected Plugins=Ausgewählte Plugins entfernen
remove=Entfernen
Select local plugin file=Wähle eine lokale Plugin-Datei
Stable=Stabil
STALE=VERALTET
Support Thread=Hilfe-Forenbeitrag
Uninstall=Deinstallieren
Update All Plugins=Alle Plugins aktualisieren
Update Incompatible=Aktualisierung inkompatibel
Update Plugin=Aktualisiere Plugin
Upgrade=Upgrade
View Release Notes=Zeige Veröffentlichungshinweise

; Note: April 21, 2025 - 1 missing translations
cannot check=
