Cancel=Abbrechen

; My PSAs / banners
Happy New Year=Frohes neues Jahr
Happy Holidays from Andrew, Tracey, and family=Frohe Feiertage von Andrew, Tracey und der Familie
Please Enjoy Responsibly=Genieße, verantwortungsvoll
Popup Blocked CA requires popups to be enabled under certain circumstances You must white list your server within your browser to allow popups=Ein Pop-up wurde blockiert. Für CA müssen Pop-ups unter bestimmten Bedingungen aktiviert sein. Du musst Pop-ups für deinen Server in deinem Browser erlauben
Docker Service Not Enabled - Only Plugins Available To Be Installed Or Managed=Docker-Dienst ist nicht aktiviert - Es können nur Plugins installiert oder verwaltet werden
Docker system failed to start - Only Plugins Available To Be Installed Or Managed=Das Docker-System konnte nicht gestartet werden. Es können nur Plugins installiert oder verwaltet werden
Array not started - Only Plugins Available To Be Installed Or Managed=Array ist nicht gestartet. Es können nur Plugins installiert oder verwaltet werden
Community Applications works best when cookies are enabled in your browser Certain features may not be available=Community Applications funktioniert am besten, wenn Browser-Cookies aktiviert sind. Bestimmte Funktionen könnten nicht verfügbar sein.
Backup Server Active Some icons may not appear, and plugin installations may be affected=Server-Sicherung aktiv. Einige Symbole werden eventuell nicht angezeigt und die Installation von Plugins kann beeinträchtigt werden
Debugging enabled This significantly increases the memory used by your browser=Debugging aktiviert. Dies erhöht den von deinem Browser verwendeten Arbeitsspeicher erheblich
Browser translation detected Display issues may result=Browser-Übersetzung erkannt - Es können Darstellungsproblemen auftreten
Action Centre Enabled=Aktionscenter aktiviert

; Sorting Options
Sort By=Sortieren nach
Name Ascending=Name aufsteigend
Name Descending=Name absteigend
Downloads=Downloads
Date Added=Datum hinzugefügt
Number Of Apps=Anzahl der Apps
; Initial disclaimer translations
Disclaimer=Haftungsausschluss
All applications listed here are 3rd party additions to Unraid Neither the authors of Community Applications nor Limetech make any warranty as to the suitability of any application listed here=Alle hier aufgelisteten Anwendungen für Unraid stammen von Drittanbietern. Weder die Autoren der Community-Anwendungen noch Limetech übernehmen jegliche Garantie über die Eignung der aufgeführten Anwendungen
Every attempt is made to ensure that only safe and compatible applications are present=Es wird alles unternommen, nur sichere und kompatible Anwendungen anzubieten
Application Policy=Anwendungsrichtlinie
I Understand=Einverstanden
Installations of apps disabled You must accept the warning to be able to install applications=Die Installation von Apps ist deaktiviert. Bitte die Warnung akzeptieren, um Anwendungen installieren zu können
Click here=Hier klicken
%s Results Per Page=%s Ergebnisse pro Seite
Results Per Page: %s=Ergebnisse pro Seite: %s

; Plugin Disclaimer
Community Applications contains both docker containers and plugin applications Plugins are designed for OS enhancements, and run with full privileges on your system and are clearly identified within CA=Community Applications enthält sowohl Docker-Container als auch Plugins. Plugins sind zur Systemverbesserungen gedacht, werden mit vollen Zugriffsrechten auf deinem System ausgeführt und sind klar innerhalb von CA gekennzeichnet
Plugin Note=Plugin-Hinweis

; Multi Install
Install Plugin Applications=Plugin installieren
Select all on page=Alle auf der Seite auswählen
Install Application=Anwendung installieren
Install Applications=Anwendungen installieren
Update Applications=Anwendungen aktualisieren
Are you sure you want to update %s applications=Bist du sicher, dass du die Anwendung %s aktualisieren möchtest
Are you sure you want to install %s docker and %s plugin applications=Bist du sicher, dass du %1$s Docker-Container und %2$s Plugin(s) installieren möchtest?

; Searches
Search=Suche
Click Here To Get More Results From DockerHub=Klick hier, um zusätzliche Ergebnisse von Docker Hub zu erhalten
No Matching Applications Found=Keine passenden Anwendungen gefunden

; Repository Related
%s removed as favourite repository=%s als Favoriten-Quelle entfernt
%s set as favourite repository=%s als Favoriten-Quelle hinzugefügt
Click to remove favourite repository=Klicken zum Entfernen der Favoriten-Quellen
Click to set %s as favourite repository=Klicken, um %s als Favoriten-Quelle hinzuzufügen
Search for apps in repository=Nach Anwendungen in Quelle suchen
No description present=Keine Beschreibung vorhanden
Go to the forum page=Forum-Beitrag aufrufen
Go to the webpage=Webpage aufrufen
Go to reddit=Reddit aufrufen
Go to facebook=Facebook aufrufen
Go to discord=Discord aufrufen
Go to forum profile=Forum-Profil aufrufen
Show Profile=Profil anzeigen
SHOW MORE=MEHR ANZEIGEN
SHOW LESS=WENIGER ANZEIGEN
Read more=Weiterlesen
Total Applications=Anwendungen insgesamt
Total Known Downloads=Downloads insgesamt
Total Docker Applications=Docker-Container insgesamt
Total Plugin Applications=Plugins insgesamt
Total Languages=Sprachen insgesamt
Average Downloads Per App=Durchschnittliche Downloads pro App
Web Page=Webseite
Forum=Forum
Forum Profile=Forum-Profil
Profile=Profil
Facebook=Facebook
Reddit=Reddit
Twitter=Twitter
Discord=Discord
Search Apps=Apps durchsuchen
Registry=Quellen-Verzeichnis
Details=Details
Added=Hinzugefügt
; Install Plugin title of openbox
Install Plugin=Plugin installieren
Update Plugin=Plugin aktualisieren

Requirements not met=Voraussetzungen nicht erfüllt
The requirements for this upgrade have not been met on your system=Die Voraussetzungen für dieses Upgrade sind auf deinem System nicht erfüllt
The sidebar for the app click info will list the details=In der Seitenleiste der App (auf "Info" klicken) werden die Details aufgeführt

BACK=ZURÜCK

; Remove App from previously installed
Delete Template=Vorlage löschen
Yes, delete it=Ja, löschen

; Uninstall popup
Uninstall Application=Anwendung deinstallieren
Yes uninstall it=Ja, deinstallieren

; Remove Private Application
Remove Private Application=Private Anwendung entfernen
Yes, remove it=Ja, entfernen

; App Pinning
Click to pin this application=Klicken, um Anwendung zu markieren
Click to unpin this application=Klicken, um die Markierung der Anwendung entfernen
Pin App=App markieren
Unpin App=App-Markierung entfernen

; Branch installations
Choose A Branch To Install=Wähle einen Zweig zum Installieren aus

; Multiple application installs
; no apps selected
Install Selected Applications=Ausgewählte Anwendungen installieren

Yes, install it=Ja, installieren

; Multi-install popup
Yes, install them=Ja, installieren
Cookies not enabled Plugins must be separately installed from docker applications=Cookies sind nicht aktiviert. Plugins müssen getrennt von Docker-Containern installiert werden
Docker applications will be installed utilizing the most recently saved template with no user input on your part=Docker-Container werden mit der zuletzt gespeicherten Vorlage installiert, ohne dass du etwas dafür tun musst
Updating Support Links=Hilfe-Links werden aktualisiert
Downloading docker icons=Lade Docker-Symbole herunter
Finished Installing If the DONE button did not appear, then you will need to click the red X in the top right corner=Installation abgeschlossen. Falls der FERTIG-Button nicht erscheint, musst du auf das rote X in der oberen rechten Ecke klicken

; error messages
No data was returned It is probable that another browser session has rebooted your server Reloading this browser tab will probably fix this error=Es wurden keine Daten zurückgesendet. Es kann sein, dass eine andere Browser-Sitzung den Server neu gestartet hat. Das Neuladen dieses Browser-Tabs behebt wahrscheinlich das Problem
An error occurred Could not find any %s Apps=Es ist ein Fehler aufgetreten. Es konnten keine %s Anwendungen gefunden werden
Download of appfeed failed=Herunterladen des App-Feeds fehlgeschlagen
; the %s here refers to a function being called
Something really went wrong here=Hier ist wirklich etwas schief gelaufen
Post the ENTIRE contents of this message in the Community Applications Support Thread=Veröffentliche den GESAMTEN Inhalt dieser Nachricht im Hilfe-Forenbeitrag der Community Applications
Unknown error happened Please post a screenshot in the support thread of the Statistics screen=Es ist ein unbekannter aufgetreten. Bitte veröffentliche einen Screenshot vom Statistik-Fenster im Hilfe-Forenbeitrag
Something really wrong happened Reloading the Apps tab will probably fix the problem=Hier ist wirklich etwas schief gelaufen. Das Neuladen des Apps-Reiters behebt wahrscheinlich das Problem
This plugin has a duplicated name from another plugin %s This will impact your ability to install both plugins simultaneously=Dieses Plugin verwendet bereits einen Name von einem anderen Plugin %s. Dies beeinträchtigt die Installation beider Plugins gleichzeitig
You have been logged out=Du wurdest abgemeldet
Fatal Flash Drive Error=Schwerer Flash-Datenträgerfehler
This usually means your flash drive is corrupted or has dropped offline The rest of the Unraid GUI will also be affected Post a new thread in the Unraid forums if this error continues=Das bedeutet in der Regel, dass dein Flash-Datenträger beschädigt ist oder nicht mehr verfügbar ist. Der Rest der Unraid-GUI ist ebenfalls betroffen. Erstelle einen neuen Beitrag im Unraid-Forum, wenn dieser Fehler weiterhin auftritt
Fatal Docker Image Error=Schwerer Docker-Imagefehler
Your docker image or folder is either read-only or completely full Issues will result because of this You should create a new post in the Unraid forums and include your diagnostics=Dein Docker-Image oder -Ordner ist entweder schreibgeschützt oder vollständig gefüllt. Dies führt zu Problemen. Du solltest einen neuen Beitrag im Unraid-Forum erstellen und deine Diagnosedaten anhängen
This template is set up to use a custom network You may have to adjust the network or IP address etc to match your system=Diese Vorlage ist für die Verwendung mit einem benutzerdefinierten Netzwerk konfiguriert. Möglicherweise musst du das Netzwerk oder die IP-Adresse usw. an dein System anpassen
This template is set up to run as Privileged This is a possible security risk and usually does not need to be enabled Note that some applications require privileged in order to operate correctly=Diese Vorlage ist so konfiguriert, dass sie mit privilegierten Rechten ausgeführt wird. Dies stellt ein mögliches Sicherheitsrisiko dar und muss normalerweise nicht aktiviert werden. Beachte, dass einige Anwendungen privilegiert sein müssen, um ordnungsgemäß zu funktionieren
One or more ports used by this application are already in use by another service or app running on your server You will need to adjust the host ports accordingly on the template=Ein oder mehrere Ports, die von dieser Anwendung verwendet werden, werden bereits von einem anderen Dienst oder einer anderen Anwendung auf deinem Server verwendet. Du musst die Host-Ports in der Vorlage entsprechend anpassen
Not Enough Memory=Nicht genügend Arbeitsspeicher
Community Applications (and Unraid OS) have a minimum required installed memory of 4G CA cannot run without those mimimums being met=Community-Anwendungen (und Unraid OS) benötigen mindestens 4 GB Arbeitsspeicher, ohne den CA nicht läuft
Installation already in progress=Installation läuft bereits
Another plugin installation or update is already in progress and this one cannot start Wait until the current installation or update is completed and try again=Eine andere Plugin-Installation oder Aktualisierung ist bereits im Gange und diese kann nicht gestartet werden. Warte, bis die aktuelle Installation oder Aktualisierung abgeschlossen ist und versuche es erneut

%s is incompatible with your OS version Please update the OS to proceed=%s ist mit deiner Betriebssystemversion nicht kompatibel. Bitte aktualisiere das Betriebssystem, um fortzufahren
%s is incompatible with your OS version Either uninstall %s or update the OS=%s ist mit deiner Betriebssystemversion nicht kompatibel. Entweder deinstalliere %s oder aktualisiere das Betriebssystem

; CA Sections Keep the length reasonable
Home=Startseite
Installed Apps=Installierte Apps
Previous Apps=Vorherige Apps
Pinned Apps=Markierte Apps
Favourite Repo=Favorisierte Apps
Action Centre=Aktionscenter
Recently Added=Kürzlich hinzugefügt
Random Apps=Zufällig Apps
Top New Installs=Top Neu-Installationen
Top Trending Apps=Top Trend-Apps
Spotlight Apps=Spotlight-Apps
All Apps=Alle Apps
Statistics=Statistiken
Credits=Danksagungen
Support=Hilfe
VERSION=VERSION
Change Log=Versionshinweise
Debugging=Debugging

; Credits
Development=Entwicklung
Additional Contributions=Zusätzliche Beteiligungen
GUI Layout Design=GUI-Layoutgestaltung
Application Feed=Anwendungs-Feed
Additional Testing=Zusätzliche Tests
Moderation=Leitung
Additional Libraries=Zusätzliche Bibliotheken
Copyright=Urheberrecht
Translation=Übersetzung

; Statistics page

unknown=Unbekannt
Last Change To Application Feed=Letzte Änderungen im Anwendungs-Feed
Docker Applications=Docker-Container
Plugin Applications=Plugins
Templates=Vorlagen
Official Containers=Offizielle Container
Repositories=Quellen
Private Docker Applications=Private Docker-Container
Invalid Templates=Ungültige Vorlagen
Template Errors=Vorlagenfehler
Blacklisted Apps=Apps auf der Sperrliste
Incompatible Applications=Inkompatible Anwendungen
Deprecated Applications=Veraltete Anwendungen
Moderation Entries=Moderationseinträge
Primary Server=Primärer Server
Backup Server=Sicherungsserver
Installs not allowed from this page=Installationen von dieser Seite sind nicht erlaubt

; Statistics Popup
No invalid templates found=Keine ungültigen Vorlagen gefunden
These templates are invalid and the application they are referring to is unknown=Diese Vorlagen sind ungültig und die Anwendung, auf die sie sich beziehen, ist unbekannt
No templates were automatically fixed=Keine Vorlage wurde automatisch korrigiert
All of these errors found have been fixed automatically=Alle diese gefundenen Fehler wurden automatisch behoben
Note that many of these errors can be avoided by following the directions=Viele dieser Fehler können vermieden werden, wenn du die Anweisungen befolgst
HERE=HIER
The following plugins have duplicated filenames and are not able to be installed simultaneously=Die folgenden Plugins haben doppelte Dateinamen und können daher nicht gleichzeitig installiert sein
The following docker applications refer to the same docker repository but may have subtle changes in the template to warrant this=Die folgenden Docker-Container beziehen sich auf die gleiche Docker-Quelle, weisen aber eventuell geringfügige Änderungen in der Vorlage auf, die das rechtfertigen
If any of these entries are incorrect then contact the moderators of CA to discuss=Falls einer der Einträge falsch ist, kontaktiere die Moderator:innen von CA
Global Repository Comments=Globale Quellen-Kommentare
Applied to all applications=(Auf alle Anwendungen angewandt)
Individual Application Moderation=Individuelle Anwendungsmoderation

; Misc
Community Applications Changelog=Community Applications Versionshinweise

Each month we highlight some of the amazing work from our community=Jeden Monat heben wir einige der großartigen Beiträge aus unserer Community hervor
Check out these newly added applications from our awesome community=Sehe dir diese neu hinzugefügten Anwendungen aus unserer großartigen Community an
Check out these up and coming apps=Sehe dir diese neuen Apps an
These apps have the highest percentage of new installs=Diese Anwendungen haben den höchsten Anteil an Neuinstallationen
An assortment of randomly chosen apps=Eine Auswahl zufällig ausgewählter Anwendungen
Featured Applications=Vorgestellte Anwendungen

; Categories try not to be excessively long This is displayed on the left of CA screen

Backup=Sicherung
Cloud=Cloud
Crypto Currency=Kryptowährung
Downloaders=Downloader
Drivers=Treiber
Game Servers=Spiele-Server
Home Automation=Heimautomatisierung
Media Applications=Medienanwendungen
Books=Bücher
Music=Musik
Photos=Fotos
Video=Video
Other=Andere
Media Servers=Medien-Server
Network Services=Netzwerkdienste
DNS=DNS
FTP=FTP
Management=Verwaltung
Messenger=Messenger
Proxy=Proxy
VOIP=VOIP
VPN=VPN
Web=Web
Privacy=Datenschutz
Productivity=Produktivität
Security=Sicherheit
Spotlight=Spotlight
Tools Utilities=Werkzeuge / Dienstprogramme
System=System
Themes=Themes
Utilities=Dienstprogramme
Private Apps=Private Anwendungen
Uncategorized=Ohne Kategorie

; Categories displayed within a popup or on the card.  Where an entry exists after the "=" it is not translated, but rather how it should look
GameServers=Spiele-Server
HomeAutomation=Heimautomatisierung
MediaApp=Medienanwendungen
MediaAppBooks=Medienanwendungen:Bücher
MediaAppMusic=Medienanwendungen:Musik
MediaAppPhotos=Medienanwendungen:Fotos
MediaAppVideo=Medienanwendungen:Video
MediaAppOther=Medieanwendungen:Andere
MediaServer=Medien-Server
MediaServerBooks=Medien-Server:Bücher
MediaServerMusic=Medien-Server:Musik
MediaServerPhotos=Medien-Server:Fotos
MediaServerVideo=Medien-Server:Video
MediaServerOther=Medien-Server:Andere
Network=Netzwerk
NetworkDNS=Netzwerk:DNS
NetworkFTP=Netzwerk:FTP
NetworkManagement=Netzwerk:Verwaltung
NetworkProxy=Netzwerk:Proxy
NetworkVOIP=Netzwerk:VOIP
NetworkVPN=Netzwerk:VPN
NetworkPrivacy=Netzwerk:Datenschutz
NetworkWeb=Netzwerk:Web
NetworkOther=Netzwerk:Andere
ToolsSystem=Werkzeuge:System
ToolsThemes=Werkzeuge:Themes
ToolsUtilities=Werkzeuge:Dienstprogramme
OtherUncategorized=Andere:Ohne Kategorie
and %s more=und %s mehr

; App Popup Related
This application template has been blacklisted=Diese Anwendungsvorlage wurde auf die Sperrliste gesetzt
This application template has been deprecated=Diese Anwendungsvorlage ist veraltet
This application has additional requirements=Diese Anwendung hat zusätzliche Anforderungen
Additional Requirements=Zusätzliche Anforderungen
Donate To Author=An Autor:in spenden
Donate To Maintainer=Spende an Betreuer:in
CLOSE=SCHLIEßEN
Author=Autor:in
Maintainer=Betreuer:in
DockerHub=Docker Hub
Application Template=Anwendungsvorlage
DockerHub Stars=Docker Hub Sterne
Added to CA=Hinzugefügt zu CA
Date Updated=Aktualisierungsdatum
Current Version=Aktuelle Version
Min OS=Minimales OS
Max OS=Maximales OS
Total Downloads=Downloads insgesamt
Popularity=Beliebtheit
Licence=Lizenz
Ranked #%s=Platz #%s
; as in Trending up or down arrow
Trending %s=Trend nach %s
; as in As of some date
As of %s=Stand %s
Play Video=Video abspielen
Play Video %s=Video %s abspielen
This application is not compatible with your version of Unraid=Diese Anwendung ist nicht kompatible mit deiner Version von Unraid
Another browser tab or device has updated the displayed templates Some actions are not available=Ein anderer Browser-Tab oder ein anderes Gerät hat die angezeigte Vorlage aktualisiert. Einige Aktionen sind nicht verfügbar
WebUI=WebUI
Reinstall=Neuinstallation
Reinstall From Previous Apps=Neuinstallation aus vorherigen Apps
Install=Installieren
Uninstall=Deinstallieren
Project=Projekt
Read Me First=Lies mich zuerst
Install second instance=Zweite Instanz installieren
Install Using The Templates Default Tag=Mit den Standard-Vorgaben der Vorlage installieren
Moderator Comments=Moderator:innen-Kommentare
Note not all authors keep up to date on change logs=Beachte, dass nicht alle Autor:innen die Versionshinweise regelmäßig aktualisieren
Note not all maintainers keep up to date on change logs=Beachte, dass nicht alle Betreuer:innen die Versionshinweise regelmäßig aktualisieren
Last Update=Zuletzt aktualisiert
Note All statistics are only gathered every 30 days=Hinweise - Alle Statistiken werden nur alle 30 Tage generiert
;the following if using a space you MUST use nbsp but keep it down to one word if at all possible
Donate=Spenden
Currently Installed Version=Aktuell installierte Version
Install The Update=Aktualisierung installieren
; as in you have the latest version already installed
Latest Version=Aktuellste Version
Multi Language Support=Mehrsprachenunterstützung
Support Forum=Hilfe-Forum
; as in more than 100000
More than %s=Mehr als %s
Remove from Previous Apps=Aus vorherigen Anwendungen entfernen
Remove=Entfernen
See All Apps=Alle Apps anzeigen
Favourite=Favorit
Application Type=Anwendungstyp

; Graphs
Trend Per Month=Trend pro Monat
Downloads Per Month=Downloads pro Monat

; Multi install script
Installing docker applications %s=Docker-Container %s wird installiert
Starting %s=%s startet
%s failed to start You should install it by itself to fix the errors=%s konnte nicht gestartet werden. Bitte selbst installieren, um die Fehler zu beheben
Setting installed applications to autostart=Installierte Anwendung auf Autostart stellen
Docker Application Installation finished=Installation des Docker-Containers abgeschlossen

; Application Cards
Actions=Aktionen
Pending=Ausstehend
This application is a driver plugin=Diese Anwendung ist ein Treiber (Plugin)
This is a language pack=Dies ist ein Sprachpaket
This application is a docker container=Diese Anwendung ist ein Docker-Container
This application is a plugin=Diese Anwendung ist ein Plugin
This is a spotlight application=Dies ist eine Spotlight-Anwendung
This is your favourite repository=Dies ist deine favorisierte Quelle
This application is from your favourite repository=Diese Anwendung stammt aus deiner favorisierten Quelle
This application is pinned for later viewing=Diese Anwendung ist für später markiert
Private Application=Private Anwendung
Remove Application From List=Anwendung aus Liste entfernen
Check off to select multiple reinstalls=Abwählen, um mehrere Neuinstallationen ausführen zu können
Go to the plugin settings=Gehe zu den Plugin-Einstellungen
Click to reinstall the application using default values=Klicken, um die Anwendung mit Standardvorgaben neu zu installieren
Click to edit the application values=Klicken, um die Anwendungsparameter zu ändern
Click to reinstall=Klicken zur Neuinstallation
Click to install=Klicken zum Installieren
Click to go to the WebUI=Klicken, um zur WebUI zu gehen
This application template has been deprecated=Diese Anwendungsvorlage ist veraltet
This application template has been blacklisted=Diese Anwendungsvorlage wurde auf die Sperrliste gesetzt
Click info to see the notes regarding this application=Klicke auf "Info", um die Hinweise zu dieser Anwendung zu sehen
This application has additional requirements=Diese Anwendung hat zusätzliche Anforderungen
BETA=BETA
INSTALLED=INSTALLIERT
OFFICIAL=OFFIZIELL
UPDATED=AKTUALISIERT
This is an official container=Dies ist ein offizieller Container
Digitally Signed=Digital signiert
This container is digitally signed=Dieser Container ist digital signiert
Docker Hub=Docker Hub
NOTE You must visit the dockerHub page to gather the information required to install correctly=HINWEIS: Du musst die Docker-Hub-Seite besuchen, um die für eine korrekte Installation erforderlichen Informationen zu erhalten
Show CA templates=CA-Vorlagen anzeigen
Deprecated=Veraltet
Incompatible=Inkompatibel
Blacklisted=Gesperrt
Template Exists=Vorlage vorhanden
Template already exists in Apps=Die Vorlage ist bereits in den Apps vorhanden
; eg: LinuxServer Repository
%s Repository=%s-Quelle
; eg: Squid's Repository
%s's Repository=Quelle von %s

Info=Info
Attention=Achtung
Repository=Quelle
Why we picked it=Warum wir es ausgewählt haben
Application Spotlight %s=Anwendungs-Spotlight %s
Unraid Staff=Unraid-Mitarbeiter:innen

; Page Navigation
Displaying %s - %s of %s=Zeige %1$s - %2$s (von %3$s)

Updating Content=Aktualisiere Inhalte
Language=Sprache
Switch to this language=Wechsle zur Sprache
Country Code=Ländercode
Install Language Pack=Sprachpaket installieren
Remove Language Pack=Sprachpaket entfernen
Update Language Pack=Sprachpaket aktualisieren
Installed Version=Installierte Version
A note about translations=Hinweis zu den Übersetzungen
Click here to view the language changelog=Klicken, um die Versionshinweise der Übersetzung anzuzeigen
View Missing Translations=Fehlende Übersetzungen anzeigen

; Update Checks
Check For Updates=Nach Aktualisierungen suchen
Check for updates already running=Es wird bereits nach Aktualisierungen gesucht
Checking for docker container updates=Suche nach Aktualisierungen für Docker-Container
Checking for plugin updates=Suche nach Aktualisierungen für Plugins
Checking for language updates=Suche nach Aktualisierungen für Sprachen
Checking %s=Suche %s

; dockerHub conversions
Determine configuration=Konfiguration ermitteln
Would you like CA to attempt to determine any applicable paths, ports, and variables for the template This will entail performing a test installation of the container It will be automatically deleted after processing The container will not be started=Möchtest du, dass CA versucht, alle anwendbaren Pfade, Ports und Variablen für die Vorlage zu ermitteln? Dazu muss eine Testinstallation des Containers durchgeführt werden. Dieser wird nach der Verarbeitung automatisch gelöscht. Der Container wird nicht gestartet.
An error occurred - Could not determine configuration=Ein Fehler ist aufgetreten - Konfiguration konnte nicht ermittelt werden
; WebGui
Click Install to download and install the Community Applications plugin=Klicke auf **Installieren**, um das **Community Applications**-Plugin herunterzuladen und zu installieren


; Note: April 29, 2023 - 114 missing translations
